vedno pri glagolih -ise dodan -ize, prin nouns -isation -ization
- our, -or
zraven  dodan THAT ali TO, glede na to/that clause, mora biti interpretirano * to
2.4 certainlty/likelihood razdeljeni na

K evaluation dodane razlicice od okay
o.k., ok

CERTAINTY
certain to	a
due to	a
guaranteed to	a
liable to	a
sure to	a

LIKELIHOOD
apt to	a
likely to	a
prone to	a
unlikely to	a

SPODNJE SAMOSTALNIKE bi lahko tudi RAZVRSTILI, zdaj samostojna lista
agreement	n
authority	n
commitment	n
confidence	n
decision	n
desire	n
determination	n
duty	n
failure	n
inclination	n
intention	n
obligation	n
opportunity	n
plan	n
potential	n
promise	n
proposal	n
readiness	n
reluctance	n
responsibility	n
right	n
scheme	n
temptation	n
tendency	n
threat	n
wish	n
willingness	n

